1111111111111111111111111111111111111111111
1000000000000000010000000000000000000000001
1000000000000000010000000000000000000000001
1000000000000000010000000000000000000000001
1000100000000000010000000000000000000000001
100000000000P000011111111111111100000000001
10000000000000000000100C0000000100000000001
10000100000000E000000CC0CC00000100000000001
100000000000000000001C0000C0000100000000001
1000000000000000111111111111111100000000001
100C000000000001000000000000000000000000001
1111111111111111111111111111111111111111111
