1111111111111111111111111111111111111111111
1000000000000000010000000000000000000000001
1000000000000000010000000000000000000000001
1000000000000000010000000000000000000000001
1000100000000000010000000000000000000000001
100000000000P000011111111111111100000000001
10000000000000000000000C0000000100000000001
100001000000000000000CC0CC00000100000000001
100000000000000000000C0000C0000100000000001
1000000000000000011111111111111100000000001
100C0000000000000E0000000000000000000000001
1111111111111111111111111111111111111111111
