1111111111111111111111111111111111111111111
1000000000000000010000000000000000000000001
1000000000000000010000000000000000000000001
1000000000000000010000000000000000000000001
1000100000000000010000000000000000000000001
1000000000NPN000N11111111111111100000000001
10000000000000000000100C0000000000000000001
100001000000000000000CC1CC00000100000000001
1000000000000000N0001C0000C0000100000000001
100000000000000N111111111111111100000000001
100C0000000000N1E00000000000000000000000001
1111111111111111111111111111111111111111111
