1111111111111111111111111111111111111111111111111
1000000000000000000001000000000000000000000000001
1000000000000000000001000000000000000000000000001
1000000000000000000001000000000000000000000000001
1000000000000000000001000000000000000000000000001
1000000000000000000001000000000000000000000000001
1000000000000000000001000000000000000000000000001
1000000000000000000001000000000000000000000000001
1000000000000000000001000000000000000000000000001
1000000000000000000001000000000000000000000000001
1000000000000000000001000000000000000000000000001
100000000000000000000N000000000000000000000000001
10000000000000CC00000E111111000000000000000000001
1000000000000000000001000010000000000000000000001
1000000000000000000001111110000000000000000000001
10000000000C0000000001000010000000000000000000001
1000000000C0C000000001000010000000000000000000001
100000000C0P0C00000000000000000000000000000000001
10000000C00000C0000000000N00000000000000000000001
100000000C000C00000000000000000000000000000000001
10000000000C0000000000000000000000000000000000001
100000000000000000C0N0000000000000000000000000001
1000000000000000000000000000000000000000000000001
1000000000000000000000000000000000000000000000001
1000000000000000000000000000000000000000000000001
1000000000000000000000111111111111111111111111111
1000000000000000000000111111111111111111111111111
1000000000000000000000111111111111111111111111111
1000000000000000000000111111111111111111111111111
1000000000000000000000000000000000000000000000001
1000000000000000000000000000000000000000000000001
1000000000000000000000000000000000000000000000001
1000000000000000000000000000000000000000000000001
1111111111111111111111111111111111111111111111111
