1111111111111111111111111111111111111111111111111
1000000000000000000001000000000000000000000000001
1000000000000000000001000000000000000000000000001
1000000000000000000001000000000000000000000000001
1000000000000000000001000000000000000000000000001
1000000000000000000001000000000000000000000000001
1000000000000000000001000000000000000000000000001
1000000000000000000001000000000000000000000000001
1000001000000000000001000000000000000000000000001
1000000000000000000001000000000000000000000000001
1000000000000000000001000000000000000000000000001
1000000100000000000001000000000000000000000000001
1000000000000000000000101111000000000000000000001
1000000001000000000000EC0010000000000000000000001
1000000000000000000001111110000000000000000000001
1000000000000000000001000010000000000000000000001
1000000000010000000001000010000000000000000000001
10000000000P0000000000000000000000000000000000001
1000000000000000000000000000000000000000000000001
1000000000000000000000000000000000000000000000001
1000000000000000000000000000000000000000000000001
100000000000000000C000000000000000000000000000001
1000000000000000000000000000000000000000000000001
1000000000000000000000000000000000000000000000001
1000000000000000000000000000000000000000000000001
1000000000000000000000111111111111111111111111111
1000000000000000000000111111111111111111111111111
1000000000000000000000111111111111111111111111111
1000000000000000000000111111111111111111111111111
1000000000000000000000000000000000000000000000001
1000000000000000000000000000000000000000000000001
1000000000000000000000000000000000000000000000001
1000000000000000000000000000000000000000000000001
1111111111111111111111111111111111111111111111111
