1111111111111111111111111111111111111111111111111
1000000000000000000001000000000000000000000000001
1000000000000000000001000000000000000000000000001
1000000000000000000001000000000000000000000000001
1000000000000000000001000000000000000000000000001
1000000000000000000001000000000000000000000000001
1000000000000000000001000000000000000000000000001
1000000000000000000001000000000000000000000000001
1000001000000000000001000000000000000000000000001
1000000000000000000001000000000000000000000000001
1000000000000000000001000000000000000000000000001
1000000100000000000001000000000000000000000000001
100000000000000000000N101111000000000000000000001
100000000100000000000NEC0010000000000000000000001
1000000000000000000001111110000000000000000000001
10000000000000000000010N0010000000000000000000001
10000000000100000000010N0010000000000000000000001
10000000000P00000000000N0000000000000000000000001
10000000000000000000000N0000000000000000000000001
10000000000000000000000N0000000000000000000000001
10000000000000000000000N0000000000000000000000001
100000000000000000C0000N0000000000000000000000001
10000000000000000000000N0000000000000000000000001
10000000000000000000000N0000000000000000000000001
100000000000000000000NNNNNNNNNNNNNNNNNNNNNNNNNNN1
100000000000000000000N111111111111111111111111111
100000000000000000000N111111111111111111111111111
100000000000000000000N111111111111111111111111111
100000000000000000000N111111111111111111111111111
100000000000000000000NNNNNNNNNNNNNNNNNNNNNNNNNNN1
1000000000000000000000000000000000000000000000001
1000000000000000000000000000000000000000000000001
1000000000000000000000000000000000000000000000001
1111111111111111111111111111111111111111111111111
