111111111111111111111111111
10000000000000000000001C101
100000000000000000000001001
10000000000000000E000000001
100000000000000000000000001
10000P00000000000000000C001
111111111111111111111111111