11111111111111111111111111111
10000000000C1C000000000000001
10000000000C1C0000000P1111111
10000000000C1C000000000000001
1000000N000000000000000000001
1E000000000N00000000000000001
11111111111111111111111111111