111111111111111111
1E0010000100000001
100C00000100110001
100111000100000001
100000000100000001
1E0C0C0P0000C01001
111111111111111111