1111111
1000000
1110001
1111111
