1110111
1000001
1110001
1111111
