1111m11
1100001
1110001
1111111
