1111111111111111111111111111111111111111111111111111111111111111111111
1000000000000000000000001111111111000000000000000000000000000000000001
1000000000000000000000001000000000000000000000000000000000000000000001
100000000000000000000000100000000000000000000000000E000000000000000001
10000000000000000000000010000000000000000000000000C0C00000000000000011
1000000000000000000000001000000000000000000000000C000C0000000000000001
100000000000000000000000111111110000000000000000C00000C000000000000001
1000000000000000000000001P00000000000000000000000000000000000000000001
1000000000000000000000001000000000000000000000000000000000000000000001
1000000000000000000000001000000000000000000000000000000000000000000001
1000000000000000000000001000000000000000000000000000000000000000000001
1000000000000000000000001111111111000000000000000000000000000000000001
1111111111111111111111111111111111111111111111111111111111111111111111
