1111111111111111111111111111111111111111111111111111111111111111111111
1P00000000000000000000000000000000000000000000000000000000000000000001
1000000000000000000000001111111111000000000000000000000000000000000001
100000000000000000000000100000000100000000000000000C000000000000000001
1000000000000000000000001000E000010000000000000000C0C00000000000000011
100000000000000000000000100000000C000000000000000C000C0000000000000001
100000000000000000000000111111111100000000000000C00000C000000000000001
1000000000000000000000001000000000000000000000000000000000000000000001
1000000000000000000000001000000000000000000000000000000000000000000001
1000000000000000000000001000000000000000000000000000000000000000000001
1000000000000000000000001000000000000000000000000000000000000000000001
1000000000000000000000001111111111000000000000000000000000000000000001
1111111111111111111111111111111111111111111111111111111111111111111111
