111111111111111111
100010000100000001
100000000100110001
100111000E00000001
100000000100000001
1000P0000100001001
111111111111111111
