111111111111111111
1000C0000100000001
100000000100110001
100111000100000001
100000000100000001
1000P000010000C001
111111111111111111
