111111111111111111
1000C0000100000001
100000000100110001
100111000E00000001
100000000100000001
10001000010000C001
111111111111111111