11111111111
11C00100001
11000010011
11P0E100001
11111111111