11111111111
1P000000001
10000000011
100000011E1
11111111111
