11111111111
11C00100001
10000100111
10P0E100001
11111111111
