11111111111
100000000P1
1E000000011
11111111111
