11111111111
11C00100001
10000100111
10P001000E1
11111111111
