1111111111111
1C00000000001
10000E0010001
1C000000P00C1
1111111111111
