1111111111111
1PEC000000001
1111111111111
1111111111111