1111111111111
1100100001011
1100000001011
110111000E011
1100000001011
1100P00001011
110000C000011
1100001000011
1100000000011
110000C000011
1100000000011
1111111111111
