11111111111111111111111111
10000N0E0N0000000000000001
10000NNNNN000000P000000001
10000000000000000000000001
100C000C0000000000C0000001
11111111111111111111111111