1111111111111
1E010001001C1
111001C101001
1P00110000001
1111111111111