1111111111111
10010000001C1
100001C1E1001
1P00110000001
1111111111111
